NO ./texture/north_text.xpm
SO ./texture/south_text.xpm
WE ./texture/west_text.xpm
EA ./texture/east_text.xpm

F 220,100,0
C 225,30,0

1111111111111111111111111 
100000000000000000000000N1
10000000000000000000000001
10000000000000000000000001
10000000000000000000000001
10000000000000000000000001
10000000000000000000000001
10000000000000000000000001
10010010010010010010010001
11111111111111111111111111
