NO ./texture/north_text
SO ./texture/south_text
WE ./texture/west_text
EA ./texture/east_text

F 220,100,0
C 225,30,0

111   111
101   101
101111101
100000001
111111111